##########
#........#
#.#......#
#.....#..#
#...@....#
#........#
#.#......#
#....#...#
#........#
##########